ANNA - The Dansant (Original Mix)
Dirty Doering - Dagga (Original Mix)
Desert Sound Colony - Sunrise Of My Mind (Denis Horvat Remix)
YEUZ - All The Same (Original Mix) (Possible)
YEUZ - Storm (Original Mix)
Reform - Atlantide (Original Mix)
Voon - Kora (Original Mix) -- its wicked think about it
Black Coffee Gabriel Moraes Remix 
Fairmont – You’re Already There (Original Mix)
URSA MAJORIS Daniel Checkmate (get the album )
Majed Salih - Alloy Power (Original Mix)
Recondite - Warg
Stan Kolev - Meraki (Original Mix)
Miguel Lobo - Feelings (OXIA Remix)
RAY Adriatique (Get album tob ereleased in march)
Steve Bug & Langenberg - NGC 6240 (Vince Watson Reshape)
FeelingsOxia Remix Oxia, Miguel Lobo
SAMA - Curiosity (Original Mix)
Yotto - Chemicals (Original Mix)
Intuite - Compass (Original Mix)
Melody Stranger - Apathy (Morttagua Remix)
TATTVA K-os Theory
Hidden Empire - Tornado (Original Mix) 
PROPE, Dusty Kid, Matchy, Seb Legrand EXCITE EP (Excite Seb Legrand Remix)

ALbums:
Wehbba ECLIPSE EP
2pole - RESTART / WALL (Has only 2 songs so ....)
Acid Project - ACID EMPIRE
L.S.G., Oliver Lieb - WHEN IT'S DARK OUTSIDE
Aitor Ronda - LOVERATION(Needs a second listen)
Nicone, Aves Volare, David Hasert - CAN'T HIDE






